                        NO  ./textures/n.xpm
SO ./textures/s.xpm

        WE ./textures/w.xpm

EA ./textures/e.xpm

F       233,100,255



C 225,30,0

        1111111111111111111111111
        1000000000110000000000001
        1011000001110000000000001
        1001000000000000000000000
111111111111111111111110001111111
100000000011000001110100000011111
11110111111111011100000010001
11110111111111011101010010001
11000000110101011100000N10001
10000000000000001100000010001
10000000000000001101010010001
11000001100101011111011110101
11110111 1110101 101111000001
11111111 1111111 111111111111