F 220,100,0
C 225,30,03

                        NO                         ./textures/n.xpm
SO ./textures/s.xpm

EA ./textures/e.xpm

        WE ./textures/w.xpm





1111111111
1000000001
10000N0001
1000000001
1111111111
